	 	 	NO 	 	 	./ruta_a_la_textura_norte

SO ./ruta_a_la_textura_sur


   WE ./ruta_a_la_textura_oeste



EA ./ruta_a_la_textura_este












                  				F 74,74,74
	  	 	C 125,216,255



1111111111111111111111111111111
1000000000000000000000000000001
1000000000000000000000000000001
1000000000000000000000000000001
1000000000000000000000000000001
1000000000000000000000000000001
1000000000000000000000000000001
1000000000000000000000000000001
1000000000000000000000000000001
1000000000000000000000000000001
1000000000000000000000000000001
1000000000000000000000000000001
1000000000000000111110000000001
1000000000000000000000000000001
1000011111000000000000000000001
1000000000000000000000000000001
1000000000000000000000000000001
1000000000000000000000000000001
10000000000000000N0000000000001
1000000000000000000000000000001
1000000000000000000000000000001
1111111111111111111111111111111
